1111
########################____#########################
#                                                   #
#                                                   #
#                                                   #
#                                                   #
#                                                   #
#                                                   #
#                                                   #
|                                                   |
|                                                   |
|                                                   |
#                                                   #
#                                                   #
#                                                   #
#                                                   #
#                                                   #
#                                                   #
#                                                   #
########################____#########################
0111
########################____#########################
#                                                   #
#                                                   #
#                                                   #
#                                                   #
#                                                   #
#                                                   #
#                                                   #
|                                                   |
|                                                   |
|                                                   |
#                                                   #
#                                                   #
#                                                   #
#                                                   #
#                                                   #
#                                                   #
#                                                   #
#####################################################
1011
########################____#########################
#                                                   #
#                                                   #
#                                                   #
#                                                   #
#                                                   #
#                                                   #
#                                                   #
|                                                   #
|                                                   #
|                                                   #
#                                                   #
#                                                   #
#                                                   #
#                                                   #
#                                                   #
#                                                   #
#                                                   #
########################____#########################
1101
#####################################################
#                                                   #
#                                                   #
#                                                   #
#                                                   #
#                                                   #
#                                                   #
#                                                   #
|                                                   |
|                                                   |
|                                                   |
#                                                   #
#                                                   #
#                                                   #
#                                                   #
#                                                   #
#                                                   #
#                                                   #
########################____#########################
1110
########################____#########################
#                                                   #
#                                                   #
#                                                   #
#                                                   #
#                                                   #
#                                                   #
#                                                   #
#                                                   |
#                                                   |
#                                                   |
#                                                   #
#                                                   #
#                                                   #
#                                                   #
#                                                   #
#                                                   #
#                                                   #
########################____#########################
0110
########################____#########################
#                                                   #
#                                                   #
#                                                   #
#                                                   #
#                                                   #
#                                                   #
#                                                   #
#                                                   |
#                                                   |
#                                                   |
#                                                   #
#                                                   #
#                                                   #
#                                                   #
#                                                   #
#                                                   #
#                                                   #
#####################################################
0101
#####################################################
#                                                   #
#                                                   #
#                                                   #
#                                                   #
#                                                   #
#                                                   #
#                                                   #
|                                                   |
|                                                   |
|                                                   |
#                                                   #
#                                                   #
#                                                   #
#                                                   #
#                                                   #
#                                                   #
#                                                   #
#####################################################
1000
#####################################################
#                                                   #
#                                                   #
#                                                   #
#                                                   #
#                                                   #
#                                                   #
#                                                   #
#                                                   #
#                                                   #
#                                                   #
#                                                   #
#                                                   #
#                                                   #
#                                                   #
#                                                   #
#                                                   #
#                                                   #
########################____#########################
0010
########################____#########################
#                                                   #
#                                                   #
#                                                   #
#                                                   #
#                                                   #
#                                                   #
#                                                   #
#                                                   #
#                                                   #
#                                                   #
#                                                   #
#                                                   #
#                                                   #
#                                                   #
#                                                   #
#                                                   #
#                                                   #
#####################################################
0001
#####################################################
#                                                   #
#                                                   #
#                                                   #
#                                                   #
#                                                   #
#                                                   #
#                                                   #
|                                                   #
|                                                   #
|                                                   #
#                                                   #
#                                                   #
#                                                   #
#                                                   #
#                                                   #
#                                                   #
#                                                   #
#####################################################
0011
########################____#########################
#                                      ##############
#   ##############                     ##############
#   ##############                                  #
#   #####   ######                                  #
#   #####   ######                                  #
#           ##############                          #
#           ##############                          #
|                                                   #
|                                                   #
|                                                   #
#                                                   #
#                                                   #
#                                #######            #
#                         ##############            #
#                         ########                  #
#                                                   #
#                                                   #
#####################################################
1100
#####################################################
#                                                   #
#                                                   #
#            ##############  ######                 #
#            ##############  ######                 #
#            ##############  ######                 #
#                  ########  ######                 #
#            ###   ########  ######                 #
#            ####            ######                 |
#            ####            ######                 |
#            #########   ##########                 |
#                 ####   ####                       #
#                 ####   ####                       #
#   ########                                        #
#   ########                                        #
#         ##                                        #
#         ##                                        #
#                                                   #
########################____#########################
1010
########################____#########################
#                                                   #
#                                                   #
#                       #################           #
#                             #################     #
#                                    ################
##########                                          #
##################                                  #
#        #################                          #
#                 #################                 #
#                       ###########                 #
#                                                   #
#                                                   #
#                                                   #
#                      ########                     #
#                            ##                     #
#                            ##                     #
#                            ##                     #
########################____#########################
1001
#####################################################
#                                                   #
#                                                   #
#                                                   #
#                                                   #
#                                                   #
#           ############     ##                     #
#        ###############     #####                  #
|      #######                ######                #
|     ########                ########              #
|    #########                #########             #
#     ########                ########              #
#      #######                #######               #
#       ######                ######                #
#         ##########   ###########                  #
#           ########   #########                    #
#                                                   #
#                                                   #
########################____#########################
0101
#####################################################
#     ######################                        #
#                      #####                        #
#     #############    #####                        #
#     #############    #####                        #
#     ########         #####          #######       #
#     ########    ##########     ############       #
#     ########    ##########     ############       #
|     ########    ##########                        |
|     ########    ##########                        |
|     ########    ##########                        |
#     ########    ##########                        #
#     ########                                      #
#     ########                                      #
#     ######################                        #
#     ######################                        #
#     ######################                        #
#     ######################                        #
#####################################################
1111
########################____#########################
#                                                   #
#                                                   #
#                                                   #
#                                                   #
#                                                   #
#   #######      ################################   #
|   #########      ##############################   |
|   ###########      ############################   |
|   #############      ##########################   |
#   ###############      ########################   #
#              ######      #######                  #
#              ########      #####                  #
#              ##########      ##                   #
#                                                   #
#                                                   #
#                                                   #
########################____#########################
0100
#####################################################
#                                                   #
#                                                   #
#          ##############                           #
#        ################                           #
#      ##################                           #
#     ###################                           #
#    ####################                           #
#################                                   |
################      ###                           |
#  ###########       ############                   |
#                   ########################        #
#                           ##################      #
#                         #######################   #
#                       ########################    #
#                    ########################       #
#                  ########################         #
#                 ########################          #
#####################################################
1001
#####################################################
########                                            #
#######                                             #
######                                              #
#####                                               #
####         ####################             #######
###         #                                       #
##         #                                        #
|         #                                         #
|        #         #                                #
#       #         #                                 #
#      #         #                                  #
#     #         #                                   #
#              #                                    #
#             #                                     #
#            #                                      #
#           #                                       #
########################____#########################